tiempoLimite:500
pooglinsASalvar:6
pooglinsTotalNivel:10
RayoLaser:2
PlatilloVolador:10
Teletransportacion:10
TunelElectromagnetico:3

VVVVVVVVVVVVVVVVVVVVVVVVVVVVVV
VVVVVVVVVVVVVVVVVVVVVVVVVVVVVV
VVVVVVVVVVVVVVVVVVVVVVVVVVVVVV
VVVVVVVVVVVVVVVVVVVVVVVVVVVVVV
VVVVVVVVVVVVVVVVVVVVVVVVVVVVVV
VVVVVVVVVVVVVVVVVVVVVVVVVVVVVV
VVEVVVVVVVVVVVVVVVVVVVVVVVVVVV
RVVVVVVVVVVVVVVVVVVVVVVVVVVVVR
RVVVVVVVRVVVVVVVVVVVVVVVVVVVVR
RVVVVVVVRVVVVVVVVVVVVVVVVVVVVR
RTTTTTAATTTTTTFFTTTTTTVTTTTTTR
RTTTTTAATTTTTFFFFTTTTTVTTTTTTR
RTTTTTTTTTTTFFFFFFTTTTVTTTTTTR
RTTTTTTTTTTTTTTTTTTTTTVTTTTTTR
RTTTTTTTTTTTTTTTTTTTTTVTTTTTTR
RTTVVVVVVVVVVVVVVVVTTTVTTTTTTR
RTTVVVVVVVVVVVVVVVVTTTVTTTTTTR
RTTVVVVSVVVVVTTTTVVVVVVTTTTTTR
RTTTTTTTTTTTTTTTTTTTTTTTTTTTTR
RRRRRRRRRRRRRRRRRRRRRRRRRRRRRR