tiempoLimite:500
pooglinsASalvar:3
pooglinsTotalNivel:8
Teletransportacion:12
TaladroUltrasonico:8
RayoLaser:2

VVVVVVVVVVVVVVVVVVVVVVVVVVVVVV
VVVVVVVVVVVVVVVVVVVVVVVVVVVVVV
VVVVVVVVVVVVVVVVVVVVVVVVVVVVVV
VVVVVVVVVVVVVVVVVVVVVVVVVVVVVV
VVVVVVVVVVVVVVVVVVVVVVVVVVVVVV
VVVVVVVVVVVVVVVVVVVVVVVVVVVVVV
VVVVVVVVVVVVVVVVVVVVVVVVVVVVVV
VVVVVVVVVVVVVVVVVVVVVVVVVVVVVV
VVEVVVVVVVVVVVVVVVVVVVVVVVVVVV
RVVVVVVVVVVVVVVVVVVVVVVVVVVVVR
TTTTTTTTTTTTTTTTTTTTTTTTTTTTTR
RVVVVVVVVVVVVVVVVVVAVVVVVVVVVR
RVVVVVVVVVVVVVVVVVVVVVVVVVVVVV
RTTTTTTTTTTTVVVTTTTTTTTTTTTTTR
RRRRRRRRRRRRRRRRRRRRRRRTTTTTTR
RRRRRSVVVVVVVVVVTTVVVVVVVVVVVR
RRRRRRRRRRRRRRRRRRRRRRRRRRRRRR
RRRRRRRRRRRRRRRRRRRRRRRRRRRRRR
RRRRRRRRRRRRRRRRRRRRRRRRRRRRRR
RRRRRRRRRRRRRRRRRRRRRRRRRRRRRR