tiempoLimite:500
pooglinsASalvar:8
pooglinsTotalNivel:10
PlatilloVolador:0
TaladroUltrasonico:1
Teletransportacion:10
RayoLaser:0
TunelElectromagnetico:1
Congelamiento:2

VVVVVVVVVVVVVVVVVVVVVVVVVVVVVV
VVVVVVVVVVVVVVVVVVVVVVVVVVVVVV
VVVVVVVVVVVVVVVVVVVVVVVVVVVVVV
VVVVVVVVVVVVVVVVVVVVVVVVVVVVVV
VVEVVVVVVVVVVVVVVVVVVVVVVVVVVV
VVVVVVVVVVVVVVVVVVVVVVVVVVVVVV
VVVVVVVVVVVVVVVVVVVVVVVVVVVVVV
RVVVVVVVVVVVVVVVVVVVVVVVVVVVVR
RVVVVVRVVVVVVVVVVVVVVVVVVVVVVR
RVVVVVVVVVVVVVVVTTTVVVVVVVVVVR
RRRRRRTTTTHHHHHRRRRRRRRRRRRRRR
RFFFFFFAVVVVVVVVRVVVVVVVVVVVVR
RFFFFFFVVVVVVVVVRVVVVVVVVVVVVR
RFFFFFFAVVVVVVVVRVVVVVVVVVVVSR
RTTTTTTTTTTTTTTTRTTTTTTTTTTTTR
RTTTTTTTTTTTTTTTRTTTTTTTTTTTTR
RTTTTTTTTTTTTTTTRTTTTTTTTTTTTR
RTTTTTTTTTTTTTTTRTTTTTTTTTTTTR
RTTTTTTTTTTTTTTTTTTTTTTTTTTTTR
RRRRRRRRRRRRRRRRRRRRRRRRRRRRRR