tiempoLimite:500
pooglinsASalvar:3
pooglinsTotalNivel:8
Teletransportacion:10
TaladroUltrasonico:8
RayoLaser:2
Congelamiento:3
PlatilloVolador:8

RVVVVVVVVVVVVVVVVVVVVVVVVVVVVV
RVVVVVVVVVVVVEVVVVVVVVVVVVVVVV
RVVVVVVVVVVVVVVVVVVVVVVVVVVVVV
RVVVVVVVVVRRRRRRRRRRRRRVVVVVVV
RVVVVVVVVVVVVVVVVVVVVVVVVVVVVV
RVVVVVVVVVVVVVVVFFFFFFFFFFFFVV
RVVVTTTTTTTTTTTTTTTTTTTTTTTTVV
RVVVTTTTVVVVVVVVVVVVVVVVVVVVVV
RVVVVVVVVVVVVVVVVVVVVVVVVVVVVR
RVVVRRRRRRRRRRRRRAARRRRRRRRRVR
RVVVVVVVVVVVVVVVVVVVVVVVVVVVVR
RAAAAAATTTTTTTTTTVVVVVVVVVVVVV
RVVVVVVVVVVVVVVVRVVVVVVVVVVVVR
RVVVVVVVVVVVVVVVRRRRRRRRRRRVVR
RVVVVVVVVVVVVVVVVVVVVVVVVVVVVR
RVVVVVVVVVVVVVVVVHHHHHHHHHHHHR
RVVVVVVVVVVVVTTTTTTVVVVVSVVVVR
RHHHHHHHHHHHHHHHHHHHHHHHHHHHHR