tiempoLimite:500
pooglinsASalvar:8
pooglinsTotalNivel:10
TaladroUltrasonico:3
Congelamiento:2
PlatilloVolador:10

HHHHHHHHHHHHHHHHHHHHHHHHHHHHHH
HHVVHHVVVVEVVVVHHVVVVVVVVVVVVV
HHVVHHVVVVVVVVVHHVVVVVVVVVVVVV
HHVVHHVVVVVVVVVHHVVVVVVVVVVVVV
HHTTTTTTTTTTTTTTTVVVVVVVVVVVVV
HHTTTTTTTTTTTTTTTVVVVVVVVVVVVV
HHVVVVVVVVVVVVVVVVVVVVVVVVVVVV
HHVVVVVVVVVVVVVVVVVVVVVVVVVVVV
HHVVHHHHHHHHHHHHHVVVVVVVVVVVVV
HHVVVVVVVVVVVVVVVVVVVVVVVVVVVV
HHVAAAAAVVVVVVVVVVVVVVVVVVVVVV
HHVVVVVVVVVVVVVVVVVVVVVVVVVVVV
HHVVVVVVVHHHHHHHHHHHHHVVVVVVVV
HHVVVVVVVVVVVVVVVVVVVVVVVVVVVV
HHVVVVVVVVVVVVVVVVVVVVVVVVVVVV
HHVVVVVVVVVVVVVVVVVVAAAAAAVVVV
HHVVVVVVVVVVVVVVVVVVVVVVVVVVVV
HHVVVVVVVVVVVVVVVVVVVVVVVSVVVV
HHHHHHHHHHHHHHHHHHHHHHHHHHHHHH
HHHHHHHHHHHHHHHHHHHHHHHHHHHHHH