tiempoLimite:500
pooglinsASalvar:5
pooglinsTotalNivel:10
PlatilloVolador:10
TaladroUltrasonico:5
RayoLaser:7
Congelamiento:1

VVVVVVVVVVVVVVVVVVVVVVVVVVVVVV
EVVVVVVVVVVVVVVVVVVVVVVVVVVVVV
VVVVVVVVVVVVVVVVVVVVVVVVVVVVVV
VVVVVVVVVVVVVVVVVVVVVVVVVVVVVV
RRRRRRRRRRRRRRRRVVVVVVVVVVVVVV
VVVVVVVVVVVVVVVVVVVVVVVVVVVVVV
VVVVVVVVVVVVVVVVVVVVVVVVVVVVVV
VVAAAAAAAAAAAVVVVVVVVVVVVVVVVV
VVVVVVVVVVVVVVVVVVVVVVVVVFFVVV
VVVVVVVVRRRRRRRVVVVVVVVVFFFFVV
RVVVVVVVTTTTTTTVVVVVVVVFFFFFFV
RVVVVVRRRRRRRRRRRRRRRRRRRRRRRR
RVVVVVVVVVVVVVVVVVVVVVVVVVVVVV
RTTTTTTTTTTTTTTTTTTTTTTTTTTTTR
RVVVVVVVVVVVVVVVVVVVVVTTTTTTTR
RRRRRRRRRRRRRRRRRTTTTTTTTTTTTR
RVVVSVVVVVVVVVVVVVVVVVVVVVVVVR
RRRRRRRRRRRRRRRRRRRRRRRRRRRRRR
RRRRRRRRRRRRRRRRRRRRRRRRRRRRRR
RRRRRRRRRRRRRRRRRRRRRRRRRRRRRR